GGTGBBGRGGTG
GEGBBBRGBGGG
BGGTRRGGGBTB
RGRAGGBRBGTG
TGBRBGBBGGBT
RBGGGGGGBGGB
BGTRGBRBGBTG
GGBGGRTGGGGB

RDRDRRULLULULDDDRDRRRRUDRDDRURRULUURUUULRDDLDDLLLLULULULUL