GGTGBBGRGGTB
GEGBBBRGBGGG
BWGTRRGGGBTB
RGRAGGBRBGTG
TGBRGGBBGGBT
RBGGGGGGBGGB
BGTRGBRBGGTG
GGBGGRTGGGGB

RDRDRRULLULULDDDRDRRRRUDRDDRURRULUURUUULRDDLDDLLLLULULULUL