RGTGBGGBGT
GEGGBBGRGB
GGBGGTRGGR
BGGRAGGGGB
RRTRGGBBTR
RGGBGGGGRR
GGTGBBGGRB
GGBBGTGGGR
RGGBBGTGGG
RRGGTGGBBR

RRDRRDRDDLLLDLLDDRDRRRUURUURUURDLLLULULLLDDDDLURRRULLLUDRRRDD