GEGGGGRGGT
GGBRGRGGBR
GARGTGRBGB
RRTBGBGGGR
BTGTGGGRGR
GGGRGRRBRG
GGBGGGTGGR
RGBGGRGGGR

LRRRRRLDDLRDDLLLDRUUDRRDDLDRUUURRURRDUUULLRDDLDLL