GEGGGGGT
GGBGGRGG
GARGGGBB
RRGGGTGG
GGGBBGRG
TGGGBRGT
GGBBBGGG
GGTGGGTR

RRRDLULRRDUDUDDDRLLDDLLDDRRUULLLURRURUUU