GEGGGGGT
GGBGGRGG
GARGGGBB
RRGGGTGG
GGGBBGRG
TGGGBRGG
GGBBBGGG
GGTGGGGR

RRRDLULRRDUDUDDDRLLDDLLDDRRUULLLURRURUUU