GGTGGGBG
GEGBGRGG
GGGRTWGG
BGGAGGBT
GTRGGBGG
GGBBGGGR
GGTGGGGT
RGGTGBGG

RURRDDDLLLDDDRDRUUUUR